1 15 2681 7750 3993 7445 3198 7746 3201 7743 7777 7763 7765 1357 7811 7812 7929 
1 6 7750 7446 7751 2107 7757 2829 
1 4 7445 4010 7755 7756 
1 3 8516 8518 8515 
1 8 8516 8519 8469 8467 8465 8472 8476 8538 
1 43 8480 8483 219 8478 8477 8538 8439 8440 8447 8446 8449 8450 8432 8388 1747 8380 3986 8379 8398 7447 8399 2406 7945 7946 7948 7949 7947 7961 7958 7951 7940 4007 7943 7931 7930 7929 7813 7814 7769 7800 7801 7802 10648 
1 6 8480 8481 8492 8494 8500 8496 
2 17 8634 8636 8620 2102 8624 8621 8613 8611 8614 8520 8522 8526 8525 3957 8530 8527 8528 
1 20 8527 3922 2884 8536 8537 8737 8736 8733 8732 8725 8723 8731 8727 8704 8666 8664 8659 8660 8643 2681 
1 16 8530 3952 8543 8544 8545 8438 8440 8444 8443 8426 8435 1564 8402 8413 8414 3946 
2 11 8585 8590 8594 8593 8595 8570 8568 8566 8564 8565 2884 
2 11 9506 3949 8422 8421 8428 8402 1564 8407 8434 8433 8388 
1 12 8731 3973 8730 8703 8702 8707 8683 982 8682 8688 8692 8575 
1 13 8380 8392 8397 7796 7797 3324 2708 7789 7792 8648 8647 8662 8660 
1 10 3986 8385 8382 8369 8368 8376 9524 8355 9526 9522 
1 16 1564 8407 8404 8403 8375 8376 8351 8353 8350 3243 8338 4004 8340 8335 9241 9236 
1 21 7929 382 7934 7936 2867 2908 7952 3515 3329 7969 3995 7988 4020 7985 4023 8309 2935 2873 986 8336 4004 
1 16 1590 8264 8265 8286 3357 8291 8289 8290 8295 8261 8294 8299 2833 9246 9240 9236 
1 8 3357 8284 8269 8273 8274 8277 9204 9202 
1 5 3969 9324 9316 9318 2508 
1 5 2508 9321 9287 9281 1787 
1 4 9284 9285 9291 9297 
1 3 9297 9293 867 
1 4 129 9275 9294 9297 
1 2 9284 1787 
1 12 9281 9288 9299 1290 9309 9331 638 9332 3125 9336 9344 9347 
1 14 9284 9290 9292 9300 9303 829 9302 9301 9360 9363 9361 9380 2875 1292 
1 2 9347 998 
1 11 9336 9339 2834 9338 1916 9366 2689 9375 9378 9379 2875 
1 8 129 9274 9273 9264 2464 9263 9235 2879 
1 4 9202 9205 9216 380 
1 5 380 9218 9214 9264 9273 
1 7 1292 1277 9389 9387 9407 9258 3981 
1 4 3981 9260 9262 528 
1 6 9240 9239 9238 9237 9261 528 
1 2 2879 9238 
1 3 3276 9429 9430 
1 2 1292 3276 
1 7 9430 1717 9399 1448 9479 9472 2316 
1 4 9456 9457 3482 2316 
1 6 2530 9450 9442 9441 9460 9456 
1 5 2316 9481 9502 890 9506 
1 4 2316 3482 9468 9467 
1 6 2370 9419 1781 9517 9518 9522 
1 8 2370 9421 9420 9414 3964 9413 9388 1277 
1 9 3270 9405 9433 9437 9434 9439 9349 3118 3200 
1 2 3270 1717 
1 3 2530 9454 1262 
1 4 998 9348 9346 779 
1 2 867 3483 
1 7 9388 9406 9410 9549 9533 9546 81 
1 8 81 9544 9534 9532 9531 8346 8345 3243 
1 5 9532 9528 8352 9527 9522 
1 3 9522 9511 3946 
1 3 9518 9515 9516 
1 6 9516 2046 9505 9502 9481 2316 
1 4 8515 86 7460 7618 
1 20 8065 8058 3455 8057 8042 8048 3184 8047 8039 8040 1256 8037 8026 8031 8032 8030 8006 8003 8005 7992 
1 3 8005 8000 7999 
1 15 7998 7994 8085 8083 8093 8094 1814 8099 8101 8107 10548 10564 10566 10553 10561 
1 12 7998 7997 1711 2552 7856 7892 7893 7894 7904 7905 8236 2343 
1 24 8210 8207 8211 8227 8226 8225 8231 2970 8215 8250 8246 2343 8241 8240 3048 7909 7903 7868 1967 4047 7875 4030 7925 3300 
1 2 8224 8225 
1 3 8225 3452 8215 
1 6 8290 8287 2460 8222 8208 8207 
1 5 8208 8229 4063 8218 2737 
1 7 8294 8296 8257 4055 8253 8254 2343 
1 5 8257 809 8217 8252 8250 
1 12 3048 7907 4034 8320 8319 4003 8318 8317 7978 7982 7987 4023 
1 11 3243 8349 8342 8302 8362 8361 2938 7990 7960 4005 8399 
1 2 7990 4020 
1 3 7960 3298 7961 
1 8 7960 7959 7970 7971 7955 3515 7968 7966 
1 7 7982 7980 4028 7967 1523 4012 2867 
1 5 1523 7974 4033 3300 382 
1 11 3300 7923 7924 7912 7913 7918 7911 1968 7842 4080 3456 
1 6 7893 689 7853 7844 7843 7842 
1 3 7746 7745 7779 
1 7 7811 7767 7766 7764 7760 7758 7755 
1 2 7758 4010 
1 3 7801 2714 7758 
1 3 7755 7756 7801 
1 4 7801 4032 7804 642 
1 2 4010 7757 
1 2 2829 10649 
1 6 7868 7867 7877 7876 7874 7912 
1 11 7912 7917 7916 4048 7829 1898 7822 7823 7819 7816 7814 
1 2 4049 7822 
1 4 7819 7818 3422 7920 
1 5 7822 7826 1919 190 10561 
1 3 7814 3304 7811 
1 4 8318 7870 2966 7871 
1 2 7967 3354 
1 2 7952 7951 
5 3 3826 11509 3367 
1 6 3367 11517 11516 2664 3403 7454 
1 4 11496 11492 11491 11490 
1 3 11490 11508 3367 
1 7 3403 11527 11520 11502 11500 11501 11496 
1 4 3367 11507 11506 11505 
1 2 11490 11506 
1 6 1004 3488 10426 10427 10478 10480 
1 2 10480 10481 
1 3 10482 10497 10506 
1 7 10506 10503 10501 10500 10520 10522 3770 
1 5 10522 3768 1539 936 10541 
1 4 3770 10521 2976 10530 
1 4 3770 10519 10534 10536 
1 5 3770 10519 10532 3271 10517 
1 4 10541 11538 11539 2557 
1 5 7449 11569 1948 11570 2591 
1 8 1004 11592 11591 11593 11597 11598 11580 7452 
1 7 7452 11571 11551 11555 11552 11553 7449 
1 7 7449 11567 11564 11565 1741 11644 7450 
1 3 7450 11670 11669 
1 6 11505 11981 11985 11986 11987 7458 
1 11 7458 11989 11622 11623 11621 11655 11632 11633 11639 3808 7450 
1 11 11501 3829 11495 10325 2723 10330 10334 10335 10329 10357 10236 
1 4 10236 10356 10403 10235 
1 2 10235 10402 
1 2 10402 641 
1 2 641 10466 
1 5 7464 7671 7684 7682 1423 
1 6 10235 10405 10414 10378 10445 10450 
1 4 10450 10448 1318 10447 
1 8 10447 10446 10444 10435 10510 10511 10513 10515 
1 6 10235 10401 10385 10384 10380 10392 
1 12 10392 10393 10306 3485 7608 7614 7611 7609 7606 7603 7467 7471 
1 3 7606 7466 7465 
1 3 7465 7485 1016 
1 6 7618 7622 7623 7649 7640 7463 
1 10 7463 7642 7648 2128 7670 7740 7734 7724 7728 7727 
1 7 7500 7461 7505 7507 7509 7510 7514 
1 9 7514 7516 1655 12076 12077 12069 12062 12059 3358 
1 6 10234 10241 10280 10286 10254 509 
1 7 509 10262 10263 10264 12066 12063 12059 
1 10 3358 12055 125 12041 1974 11996 11997 11998 2730 7458 
1 7 7458 2953 11999 12007 12008 12045 7456 
1 7 12051 12050 12127 12129 470 12132 12131 
1 5 12051 12106 12123 12126 7457 
1 2 12126 12129 
1 4 7457 12124 12136 12137 
1 2 12137 98 
1 3 470 12025 12026 
1 8 2736 1584 11695 11685 11687 11686 11672 11673 
1 7 1355 12103 200 1444 3867 12121 12124 
