1 7 3201 7746 3198 7445 3993 7750 2681 
1 6 7750 7446 7751 2107 7757 2829 
1 4 7445 4010 7755 7756 
1 3 8516 8518 8515 
1 8 8516 8519 8469 8467 8465 8472 8476 8538 
1 42 8480 8483 219 8478 8477 8538 8439 8440 8447 8446 8449 8450 8432 8388 1747 8380 3986 8379 8398 7447 8399 2406 7945 7946 7948 7949 7947 7961 7958 7951 7940 4007 7943 7931 7930 7929 7813 7814 7769 7800 7801 7802 
1 6 8480 8481 8492 8494 8500 8496 
2 17 8634 8636 8620 2102 8624 8621 8613 8611 8614 8520 8522 8526 8525 3957 8530 8527 8528 
1 20 8527 3922 2884 8536 8537 8737 8736 8733 8732 8725 8723 8731 8727 8704 8666 8664 8659 8660 8643 2681 
1 16 8530 3952 8543 8544 8545 8438 8440 8444 8443 8426 8435 1564 8402 8413 8414 3946 
2 11 8585 8590 8594 8593 8595 8570 8568 8566 8564 8565 2884 
2 11 9506 3949 8422 8421 8428 8402 1564 8407 8434 8433 8388 
1 12 8731 3973 8730 8703 8702 8707 8683 982 8682 8688 8692 8575 
1 13 8380 8392 8397 7796 7797 3324 2708 7789 7792 8648 8647 8662 8660 
1 10 3986 8385 8382 8369 8368 8376 9524 8355 9526 9522 
1 16 1564 8407 8404 8403 8375 8376 8351 8353 8350 3243 8338 4004 8340 8335 9241 9236 
1 21 7929 382 7934 7936 2867 2908 7952 3515 3329 7969 3995 7988 4020 7985 4023 8309 2935 2873 986 8336 4004 
1 16 1590 8264 8265 8286 3357 8291 8289 8290 8295 8261 8294 8299 2833 9246 9240 9236 
1 8 3357 8284 8269 8273 8274 8277 9204 9202 
1 5 3969 9324 9316 9318 2508 
1 5 2508 9321 9287 9281 1787 
1 4 9284 9285 9291 9297 
1 3 9297 9293 867 
1 4 129 9275 9294 9297 
1 2 9284 1787 
1 12 9281 9288 9299 1290 9309 9331 638 9332 3125 9336 9344 9347 
1 14 9284 9290 9292 9300 9303 829 9302 9301 9360 9363 9361 9380 2875 1292 
1 2 9347 998 
1 11 9336 9339 2834 9338 1916 9366 2689 9375 9378 9379 2875 
1 8 129 9274 9273 9264 2464 9263 9235 2879 
1 4 9202 9205 9216 380 
1 5 380 9218 9214 9264 9273 
1 7 1292 1277 9389 9387 9407 9258 3981 
1 4 3981 9260 9262 528 
1 6 9240 9239 9238 9237 9261 528 
1 2 2879 9238 
1 3 3276 9429 9430 
1 2 1292 3276 
1 7 9430 1717 9399 1448 9479 9472 2316 
1 4 9456 9457 3482 2316 
1 6 2530 9450 9442 9441 9460 9456 
1 5 2316 9481 9502 890 9506 
1 4 2316 3482 9468 9467 
1 6 2370 9419 1781 9517 9518 9522 
1 8 2370 9421 9420 9414 3964 9413 9388 1277 
1 9 3270 9405 9433 9437 9434 9439 9349 3118 3200 
1 2 3270 1717 
1 3 2530 9454 1262 
1 4 998 9348 9346 779 
1 2 867 3483 
1 7 9388 9406 9410 9549 9533 9546 81 
1 8 81 9544 9534 9532 9531 8346 8345 3243 
1 5 9532 9528 8352 9527 9522 
1 3 9522 9511 3946 
1 3 9518 9515 9516 
1 6 9516 2046 9505 9502 9481 2316 
1 4 8515 86 7460 7618 
