1 7 3201 7746 3198 7445 3993 7750 2681 
1 6 7750 7446 7751 2107 7757 2829 
1 4 7445 4010 7755 7756 
1 3 8516 8518 8515 
1 8 8516 8519 8469 8467 8465 8472 8476 8538 
1 42 8480 8483 219 8478 8477 8538 8439 8440 8447 8446 8449 8450 8432 8388 1747 8380 3986 8379 8398 7447 8399 2406 7945 7946 7948 7949 7947 7961 7958 7951 7940 4007 7943 7931 7930 7929 7813 7814 7769 7800 7801 7802 
1 6 8480 8481 8492 8494 8500 8496 
2 17 8634 8636 8620 2102 8624 8621 8613 8611 8614 8520 8522 8526 8525 3957 8530 8527 8528 
1 20 8527 3922 2884 8536 8537 8737 8736 8733 8732 8725 8723 8731 8727 8704 8666 8664 8659 8660 8643 2681 
1 16 8530 3952 8543 8544 8545 8438 8440 8444 8443 8426 8435 1564 8402 8413 8414 3946 
2 11 8585 8590 8594 8593 8595 8570 8568 8566 8564 8565 2884 
2 11 9506 3949 8422 8421 8428 8402 1564 8407 8434 8433 8388 
1 12 8731 3973 8730 8703 8702 8707 8683 982 8682 8688 8692 8575 
1 13 8380 8392 8397 7796 7797 3324 2708 7789 7792 8648 8647 8662 8660 
1 10 3986 8385 8382 8369 8368 8376 9524 8355 9526 9522 
1 16 1564 8407 8404 8403 8375 8376 8351 8353 8350 3243 8338 4004 8340 8335 9241 9236 
1 21 7929 382 7934 7936 2867 2908 7952 3515 3329 7969 3995 7988 4020 7985 4023 8309 2935 2873 986 8336 4004 
1 16 1590 8264 8265 8286 3357 8291 8289 8290 8295 8261 8294 8299 2833 9246 9240 9236 
1 8 3357 8284 8269 8273 8274 8277 9204 9202 
